You wake up in a steaming hot bath. Suddenly, a huge hand lifts the ceiling of the container you are in. Light surrounds you, and you realize you are in a steamer with five other steamed buns. A huge set of chopsticks reach in and grab the steamed bun next to you. You really need to find a way out before you are next.

Dinner
An Interactive Fiction by mloo19
Release 1 / Serial number 190314 / Inform 7 build 6M62 (I6/v6.33 lib 6/12N) SD

Steamer
A round, bamboo steamer resting on a pot of boiling water. The Human's chopsticks rest in the steamer, and five other steamed buns are huddled next to you. The cover is on the steamer, but you notice light coming through a crack in the top.

The Human stands over the Steamer, ready to grab the next steamed bun.

>put chopsticks in crack
You nudge the chopsticks into the crack until you know you have good leverage. Now all you have to do is open the steamer.

"I'm hungry," The Human says.

>push chopsticks
You can't see any such thing.

* * *

>put chopsticks in the crack
You nudge the chopsticks into the crack until you know you have good leverage. Now all you have to do is open the steamer.

"I'm hungry," The Human says.

* * *

>put the chopsticks in the crack
You nudge the chopsticks into the crack until you know you have good leverage. Now all you have to do is open the steamer.

"I'm hungry," The Human says.

* * *

>x human
An old, Chinese woman.