You wake up in a steaming hot bath. Suddenly, a huge hand lifts the ceiling of the container you are in. Light surrounds you, and you realize you are in a steamer with five other steamed buns. A huge set of chopsticks reach in and grab the steamed bun next to you. You really need to find a way out before you are next.

Dinner
An Interactive Fiction by mloo19
Release 1 / Serial number 190422 / Inform 7 build 6M62 (I6/v6.33 lib 6/12N) SD

Steamer
A round, bamboo steamer resting on a pot of boiling water. The Human's chopsticks rest in the steamer, and five other steamed buns are huddled next to you. The cover is on the steamer, but you notice light coming through a crack in the top.

Steve is a fellow steamed bun huddled in the corner of the Steamer also trying not to be eaten.

You can also see a Chopsticks here.

>Test STM
(Testing.)

>[1] put chopsticks in crack
You nudge the chopsticks into the crack until you know you have good leverage. Now all you have to do push the chopsticks to get the cover off.

>[2] push chopsticks
You roll onto the end of the chopsticks, making the crack wider. After a couple more seconds, the cover is off, and it falls to the Kitchen Table Top. Now you can escape!

The Human turns to see what the noise was.

>[3] down.
Kitchen Table Top
 You land on the granite surface behind the Cover, so the Human can't see you.  The Human's cutting board and a napkin holder lie on the surface.

The Human is super hungry, and she waits for the steamed buns to finish cooking.

You can also see a Chopsticks, a Cutting Board (on which is a Green Onions) and a Napkin Holder here.

The Human goes towards the the Cabinet.

* * *

>climb on buns
You can't see any such thing.

* * *

>climb steamed buns
You climb on top of the Steamed Bun next to you, but the cover is still closed, preventing you from escaping.

>get on steam buns
You can't see any such thing.

* * *

>get on steamed buns
That's not something you can enter.

>stand on steamed buns
That's not something you can stand on.

>stand on buns
That's not something you can stand on.

>climb on buns
You can't see any such thing.

* * *

>pick up chopsticks
You try, but you don't have any hands yet. You can still push things though.

>push the cover
You try, but you can't quite reach that high. Maybe use something in the Steamer to put in the Crack to help you open the Crack wider.

>push the chopsticks
You push the Chopsticks around and accidentally poke one of the other steamed buns!

>push steam bun
You bump into one, and he gives you a dirty look in return. "That wasn't helpful," you think.

>stand on steve
He's not something you can stand on.

>stand on chopsticks
That's not something you can stand on.

>push steve
You bump into Steve, and he gives you a funny look in return. "Maybe I should talk to him," you think.

>talk to steve
"Hi, there," you say.

"Hi," he replies nervously.

"How long have you been in here," you ask.

"Long enough to know what's about to happen," Steve replies. 

"Do you know how to get out of here?" you ask.

Steve looks around nervously. "I heard the last successful steamed bun was able to escape after eating some green onion from the cutting board. But that was years ago, and you have to figure out how to get out of the steamer."

After hearing this, you decide against talking any further with Steve right now.

>get out of steamer
I only understood you as far as wanting to get outside.

>eat some green onion
You can't see any such thing.

>put chopsticks in crack
You nudge the chopsticks into the crack until you know you have good leverage. Now all you have to do push the chopsticks to get the cover off.

>push chopsticks
You roll onto the end of the chopsticks, making the crack wider. After a couple more seconds, the cover is off, and it falls to the Kitchen Table Top. Now you can go down and escape!

The Human turns to see what the noise was.

>go down and escape
You can't use multiple objects with that verb.

>go down
Kitchen Table Top
 You land on the granite surface behind the Cover, so the Human can't see you.  The Human's Cutting Board and a Napkin Holder lie on the surface. After looking around, you see a Window, but it is elevated. You need to figure out a way to get out of the Window.

The Sink is to the east, and the Cabinet is to the West.

The Human is super hungry, and she waits for the steamed buns to finish cooking.

You can also see a Chopsticks here.

>go to the cutting board
You can't see any such thing.

>examine cutting board
Freshly cut Green Onions lie on the Cutting Board.

>eat green onions
You roll over the Cutting Board and eat a green onion, and then you feel a tingling in your body. Suddenly, you watch as two arms grow out of your body.

>do push ups
You test the strength of your arms by pumping out a couple of push-ups.

>go to napkin holder
You can't see any such thing.

>est
That's not a verb I recognise.

>e
Sink
A basin filled halfway with soapy water. The water level is too deep for you to roll across, but will keep you hidden from the Human.

 The Kitchen Table Top is to the west, and the Plate is to the east.

You can see a Sponge here.

* * *

>jump
You jump on the spot.

>duck down
That's not a verb I recognise.

>hide
(behind the Sponge)
You roll behind the Sponge. Now the Human can't see you.

>east
You plop into the water and slowly sink to the bottom.

    *** The End ***

Would you like to RESTART, RESTORE a saved game, QUIT or UNDO the last command?

>undo
Sink
[Previous turn undone.]

>go ontop of sponge
You can't see any such thing.

* * *

>get on sponge
You roll onto the Sponge. It dips a little, but stays afloat and seem steady for your journey across the sink.

Sink (on the Sponge)
A basin filled halfway with soapy water. The water level is too deep for you to roll across, but will keep you hidden from the Human.

 The Kitchen Table Top is to the west, and the Plate is to the east.

>east
Plate (on the Sponge)
A Char Siu-filled plate. You see Crumbs near the middle of the Plate and a smear of Sauce. Your roll behind the Char Siu pile, so the Human doesn't see you.

The Sink is to the west, and you see a Bowl to the east.

>eat Char Siu
You nibble a little piece, but decide not to eat the rest because you don't want the Human to notice a huge piece is gone.

>eat crumbs
Your stomach turns at the thought of eating part of your fellow steamed bun.

>x plate
You can't see any such thing.

>w
Sink (on the Sponge)
A basin filled halfway with soapy water. The water level is too deep for you to roll across, but will keep you hidden from the Human.

 The Kitchen Table Top is to the west, and the Plate is to the east.

>e
Plate (on the Sponge)
A Char Siu-filled plate. You see Crumbs near the middle of the Plate and a smear of Sauce. Your roll behind the Char Siu pile, so the Human doesn't see you.

The Sink is to the west, and you see a Bowl to the east.

>e
Bowl (on the Sponge)
You roll and plop yourself into a pool of Rice. You sink a little into the Rice to camouflage yourself from the Human.

The Plate is to the west. You see the Window above you, but you are too short to reach your freedom.

>eat rice
You eat some, but it's so sticky that your mouth is almost glued shut. You wouldn't want to eat that again.

>undo
Bowl
[Previous turn undone.]

>e
You can't go that way.

>undo
Bowl
[Previous turn undone.]

>w
Plate (on the Sponge)
A Char Siu-filled plate. You see Crumbs near the middle of the Plate and a smear of Sauce. Your roll behind the Char Siu pile, so the Human doesn't see you.

The Sink is to the west, and you see a Bowl to the east.

>x Sauce
The Sauce seems to say "Goal: Window

Green Onions = arms.

Build ..." You struggle to read the last part as it got blurred out.

>x Window Sill
You can't see any such thing.

>Build Window Sill
I only understood you as far as wanting to build.

>use arms to get to the window sil
That's not a verb I recognise.

>go to bowl
You can't see any such thing.

>wg
That's not a verb I recognise.

>go to Bowl
You can't see any such thing.

>e
Bowl (on the Sponge)
You roll and plop yourself into a pool of Rice. You sink a little into the Rice to camouflage yourself from the Human.

The Plate is to the west. You see the Window above you, but you are too short to reach your freedom.

>jump on WindowSill
You can't see any such thing.

>up
Window (on the Sponge)
The Window is so high. It is open, letting the breeze from the outside flow through the kitchen. The beautiful blue sky and your freedom lie just on the other side.

The Bowl is below you.

You can see a Window Sill here.

>jumponto window sill
That's not a verb I recognise.

>go to Window Sill
You can't see any such thing.

>Biuld
That's not a verb I recognise.

>find tools
That's not a verb I recognise.

>go to Kitichen Table Top
You can't see any such thing.

>down
Bowl (on the Sponge)
You roll and plop yourself into a pool of Rice. You sink a little into the Rice to camouflage yourself from the Human.

The Plate is to the west. You see the Window above you, but you are too short to reach your freedom.

>west
Plate (on the Sponge)
A Char Siu-filled plate. You see Crumbs near the middle of the Plate and a smear of Sauce. Your roll behind the Char Siu pile, so the Human doesn't see you.

The Sink is to the west, and you see a Bowl to the east.

>sink
That's not a verb I recognise.

>w
Sink (on the Sponge)
A basin filled halfway with soapy water. The water level is too deep for you to roll across, but will keep you hidden from the Human.

 The Kitchen Table Top is to the west, and the Plate is to the east.

>Kitchen Table Top
That's not a verb I recognise.

>w
Kitchen Table Top (on the Sponge)
 The Human's Cutting Board and a Napkin Holder lie on the surface. After looking around, you see a Window, but it is elevated. You need to figure out a way to get out of the Window.

The Sink is to the east, and the Cabinet is to the West.

The Human is super hungry, and she waits for the steamed buns to finish cooking.

You can also see a Chopsticks here.

>w
Cabinet (on the Sponge)
The Cabinet is open. Boxes and jars of food fill the Cabinet. There is also a Utensil Crock filled with various tools.

The Kitchen Table Top is to the east.

>pick up Utensil Crock
You grab the Utensil Crock and pull, but it is too big and too heavy.

>put in inventory
I didn't understand that sentence.

>x Utensil Crock
A tall, cylindrical tool holder that houses cooking utensils. The Spatula, Toothpicks, Tongs, Whisk, and Wooden Spoon are in the Holder. Maybe you can use some of these tools to make a structure to escape out the Window.

>pick all up
There are none at all available!

>pick up Spatula
You take the Spatula with your newly grown arms.

Taken.

>pick up Toothpicks
You take the Toothpicks with your newly grown arms.

Taken.

>pick up Tongs
You take the Tongs with your newly grown arms.

Taken.

>pick up Spoon
You take the Wooden Spoon with your newly grown arms.

Taken.

>e
Kitchen Table Top (on the Sponge)
 The Human's Cutting Board and a Napkin Holder lie on the surface. After looking around, you see a Window, but it is elevated. You need to figure out a way to get out of the Window.

The Sink is to the east, and the Cabinet is to the West.

The Human is super hungry, and she waits for the steamed buns to finish cooking.

You can also see a Chopsticks here.

>e
Sink (on the Sponge)
A basin filled halfway with soapy water. The water level is too deep for you to roll across, but will keep you hidden from the Human.

 The Kitchen Table Top is to the west, and the Plate is to the east.

>e
Plate (on the Sponge)
A Char Siu-filled plate. You see Crumbs near the middle of the Plate and a smear of Sauce. Your roll behind the Char Siu pile, so the Human doesn't see you.

The Sink is to the west, and you see a Bowl to the east.

* * *

>e
Bowl (on the Sponge)
You roll and plop yourself into a pool of Rice. You sink a little into the Rice to camouflage yourself from the Human.

The Plate is to the west. You see the Window above you, but you are too short to reach your freedom.

>u
Window (on the Sponge)
The Window is so high. It is open, letting the breeze from the outside flow through the kitchen. The beautiful blue sky and your freedom lie just on the other side.

The Bowl is below you.

You can see a Window Sill here.

>d
Bowl (on the Sponge)
You roll and plop yourself into a pool of Rice. You sink a little into the Rice to camouflage yourself from the Human.

The Plate is to the west. You see the Window above you, but you are too short to reach your freedom.

>pick up rice
You take some Rice. Maybe you can use it to  glue something and another thing together.

>u
Window (on the Sponge)
The Window is so high. It is open, letting the breeze from the outside flow through the kitchen. The beautiful blue sky and your freedom lie just on the other side.

The Bowl is below you.

You can see a Window Sill here.

>glue Spatula to Toothpicks
You glue together the Spatula and the Toothpicks, creating a sturdy structure.

You now have a a Spatula-Toothpicks Thing.

>glue Spatula and Toothpicks
You can't see any such thing.

>glue Spatula
You can't see any such thing.

>Toothpicks
That's not a verb I recognise.

>glue the Spatula and the Toothpicks
You can't see any such thing.

>combine the Spatula and the Toothpicks
You can't see any such thing.

>combine the Spatula to the Toothpicks
You can't see any such thing.

>combine Spatula and Toothpicks
You can't see any such thing.

>combine Spatula and Spoon
You can't see any such thing.

>glue Spatula and Spoon
You can't see any such thing.

>glue Toothpick and Spatula
You can't see any such thing.

>combine Toothpick and Spoon
You can't see any such thing.

>combined spoon and spatula
That's not a verb I recognise.

>d
Bowl (on the Sponge)
You roll and plop yourself into a pool of Rice. You sink a little into the Rice to camouflage yourself from the Human.

The Plate is to the west. You see the Window above you, but you are too short to reach your freedom.

* * *

>pick up rice
You take some Rice. Maybe you can use it to  glue something and another thing together.

>pick up more rice
You can't see any such thing.

>u
Window (on the Sponge)
The Window is so high. It is open, letting the breeze from the outside flow through the kitchen. The beautiful blue sky and your freedom lie just on the other side.

The Bowl is below you.

You can see a Window Sill here.

>glue Spatula and Spoon
You can't see any such thing.

>glue spatula
You can't see any such thing.

>gule the spatula and spoon
That's not a verb I recognise.

>glue spatula and spoon
You can't see any such thing.

>glue spatula to spoon
You can't see any such thing.

>glue Spatula to Spoon
You can't see any such thing.

>i
You are carrying:
  a Rice
  a Spatula-Toothpicks Thing
  a Wooden Spoon
  a Tongs

>glue Spatula-Toothpicks Thing to Wooden Spoon
You glue together the Spatula-Toothpicks Thing and the Wooden Spoon, creating a sturdy structure.

You now have a a Ladder Thing.

>take Ladder Thing
You take the Ladder Thing with your newly grown arms.

You already have that.

>you win
That's not a verb I recognise.

>d
Bowl (on the Sponge)
You roll and plop yourself into a pool of Rice. You sink a little into the Rice to camouflage yourself from the Human.

The Plate is to the west. You see the Window above you, but you are too short to reach your freedom.

>u
Window (on the Sponge)
The Window is so high. It is open, letting the breeze from the outside flow through the kitchen. The beautiful blue sky and your freedom lie just on the other side.

The Bowl is below you.

You can see a Window Sill here.

>i
You are carrying:
  a Ladder Thing
  a Rice
  a Tongs

>get off sponge
You dismount the Sponge.

Window
The Window is so high. It is open, letting the breeze from the outside flow through the kitchen. The beautiful blue sky and your freedom lie just on the other side.

The Bowl is below you.

You can see a Sponge and a Window Sill here.

You prop your makeshift ladder against the Window Sill and make your escape. You Win!

    *** The End ***

Would you like to RESTART, RESTORE a saved game, QUIT or UNDO the last command?

>undo
Window
[Previous turn undone.]

>get off of sponge
You finally reach the other side.

You dismount the Sponge.
Window
The Window is so high. It is open, letting the breeze from the outside flow through the kitchen. The beautiful blue sky and your freedom lie just on the other side.

The Bowl is below you.

You can see a Sponge and a Window Sill here.

You prop your makeshift ladder against the Window Sill and make your escape. You Win!

    *** The End ***

Would you like to RESTART, RESTORE a saved game, QUIT or UNDO the last command?

* * *

>push chopsticks
You push the Chopsticks around and accidentally poke one of the other steamed buns!

>put chopsticks in crack
You nudge the chopsticks into the crack until you know you have good leverage. Now all you have to do is open the steamer.

>push chopsticks
You can't see any such thing.

* * *

>put chopsticks in crack
You nudge the chopsticks into the crack until you know you have good leverage. Now all you have to do push the chopsticks to get the cover off.

>push chopsticks
You roll onto the end of the chopsticks, making the crack wider. After a couple more seconds, the cover is off, and it falls to the Kitchen Table Top. Now you can escape!

The Human turns to see what the noise was.

* * *

>hide behind napkin holder
You can't see any such thing.

* * *

>push chopsticks
You roll onto the end of the chopsticks, making the crack wider. After a couple more seconds, the cover is off, and it falls to the Kitchen Table Top. Now you can escape!

The Human turns to see what the noise was.

>get on steamed buns
That's not something you can enter.

>climb on steamed buns
You can't see any such thing.

* * *

>put chopsticks in steamer
You can't see any such thing.

>put chopsticks in crack
You nudge the chopsticks into the crack until you know you have good leverage. Now all you have to do is open the steamer.

* * *

>put chopsticks in the crack
You nudge the chopsticks into the crack until you know you have good leverage. Now all you have to do is open the steamer.

"I'm hungry," The Human says.

>push chopsticks
You push the Chopsticks around and accidentally poke one of the steamed buns!

"I'm hungry," The Human says.

* * *

>put the chopsticks in the crack
You nudge the chopsticks into the crack until you know you have good leverage. Now all you have to do is open the steamer.

"I'm hungry," The Human says.

>push chopsticks
You can't see any such thing.

>push the chopsticks
You can't see any such thing.

* * *

>take chopsticks
You try, but you don't have any hands. Try  nudging something.

* * *

>talk to steve
"Hi, there," you say.

"Hi," he replies nervously.

"How long have you been in here," you ask.

"Long enough to know what's about to happen," Steve replies. 

"Do you know how to get out of here?" you ask.

Steve looks around nervously. "I heard the last successful steamed bun was able to escape after eating some green onion from the cutting board. But that was years ago, and you have to figure out how to get out of the steamer."

After hearing this, you decide against talking any further with Steve right now.

* * *

>talk to troy
"Hi, there," you say.

"Hi," he replies nervously.

"How long have you been in here," you ask.

"Long enough to know what's about to happen," Troy replies. 

"Do you know how to get out of here?" you ask.

Troy looks around nervously. "I heard the last successful steamed bun was able to escape after eating some green onion from the cutting board. But that was years ago, and you have to figure out how to get out of the steamer."

After hearing this, you decide against talking any further with Troy right now.

* * *

>test STM
(Testing.)

>[1] put chopsticks in crack
You nudge the chopsticks into the crack until you know you have good leverage. Now all you have to do push the chopsticks to get the cover off.

>[2] push chopsticks
You roll onto the end of the chopsticks, making the crack wider. After a couple more seconds, the cover is off, and it falls to the Kitchen Table Top. Now you can escape!

The Human turns to see what the noise was.

>[3] down.
Kitchen Table Top
 You land on the granite surface behind the Cover, so the Human can't see you. 

The Human is super hungry, and she waits for the steamed buns to finish cooking.

Freshly cut Green Onions lie on the Cutting Board.

On the Cutting Board is a Green Onions.

You can also see a Napkin Holder here.

THE HUMAN TAKES YOU!!!!

    *** The End ***

Would you like to RESTART, RESTORE a saved game, QUIT or UNDO the last command?

* * *

>test me
>--> The following tests are available:
'test STM'
'test HGA'
'test row'

* * *

>test stm
(Testing.)

>[1] put chopsticks in crack
You nudge the chopsticks into the crack until you know you have good leverage. Now all you have to do push the chopsticks to get the cover off.

>[2] push chopsticks
You roll onto the end of the chopsticks, making the crack wider. After a couple more seconds, the cover is off, and it falls to the Kitchen Table Top. Now you can go down and escape!

The Human turns to see what the noise was.

>[3] down.
Kitchen Table Top
You land on the granite surface behind the Cover, so the Human can't see you.  The Human's Cutting Board and a Napkin Holder lie on the surface. After looking around, you see a Window, but it is elevated. You need to figure out a way to get out of the Window.

The Sink is to the east, and the Cabinet is to the West.

The Human is super hungry, and she waits for the steamed buns to finish cooking.

You can also see a Chopsticks here.

>eat green onions
You roll over the Cutting Board and eat a green onion, and then you feel a tingling in your body. Suddenly, you watch as two arms grow out of your body.

* * *

>test hga
(Testing.)

>[1] hide behind napkin holder
You roll behind the Napkin Holder. Now the Human can't see you.

>[2] eat green onions
You roll over the Cutting Board and eat a green onion, and then you feel a tingling in your body. Suddenly, you watch as two arms grow out of your body.

>[3] take chopsticks.
You take the Chopsticks with your newly grown arms.

Taken.

>e
Sink
A basin filled halfway with soapy water. The water level is too deep for you to roll across, but will keep you hidden from the Human. A Sponge floats on top of the water right in front of you.

 The Kitchen Table Top is to the west, and the Plate is to the east.

You can see a Sponge here.

>get on sponge
You roll onto the Sponge. It dips a little, but stays afloat and seem steady for your journey across the sink.

Sink (on the Sponge)
A basin filled halfway with soapy water. The water level is too deep for you to roll across, but will keep you hidden from the Human. A Sponge floats on top of the water right in front of you.

 The Kitchen Table Top is to the west, and the Plate is to the east.

>e
Plate (on the Sponge)
A Char Siu-filled plate. You see crumbs near the middle of the Plate and a smear of sauce. Your roll behind the Char Siu pile, so the Human doesn't see you.

The Sink is to the west, and you see a bowl to the east.

>get off sponge
You dismount the Sponge.

Plate
A Char Siu-filled plate. You see crumbs near the middle of the Plate and a smear of sauce. Your roll behind the Char Siu pile, so the Human doesn't see you.

The Sink is to the west, and you see a bowl to the east.

You can see a Sponge here.

* * *

>e
Plate (on the Sponge)
A Char Siu-filled plate. You see crumbs near the middle of the Plate and a smear of sauce. Your roll behind the Char Siu pile, so the Human doesn't see you.

The Sink is to the west, and you see a bowl to the east.

>get on sponge
But you're already in the Sponge.

>get off sponge
But you aren't on the Sponge at the moment.

>w
Sink (in the Sponge)
A basin filled halfway with soapy water. The water level is too deep for you to roll across, but will keep you hidden from the Human. A Sponge floats on top of the water right in front of you.

 The Kitchen Table Top is to the west, and the Plate is to the east.

>undo
Plate
[Previous turn undone.]

>w
Sink (in the Sponge)
A basin filled halfway with soapy water. The water level is too deep for you to roll across, but will keep you hidden from the Human. A Sponge floats on top of the water right in front of you.

 The Kitchen Table Top is to the west, and the Plate is to the east.

* * *

>test hga
(Testing.)

>[1] hide behind napkin holder
You roll behind the Napkin Holder. Now the Human can't see you.

>[2] eat green onions
You roll over the Cutting Board and eat a green onion, and then you feel a tingling in your body. Suddenly, you watch as two arms grow out of your body.

>[3] take chopsticks.
You take the Chopsticks with your newly grown arms.

Taken.

>test row
(Testing.)

>[1] east

Sink
A basin filled halfway with soapy water. The water level is too deep for you to roll across, but will keep you hidden from the Human. A Sponge floats on top of the water right in front of you.

 The Kitchen Table Top is to the west, and the Plate is to the east.

You can see a Sponge here.

>[2] get on sponge
You roll onto the Sponge. It dips a little, but stays afloat and seem steady for your journey across the sink.

Sink (on the Sponge)
A basin filled halfway with soapy water. The water level is too deep for you to roll across, but will keep you hidden from the Human. A Sponge floats on top of the water right in front of you.

 The Kitchen Table Top is to the west, and the Plate is to the east.

>[3] east.

Plate (on the Sponge)
 You get off the Sponge and roll onto the back of the plate, so the Human can't see you. A Char Siu-filled plate. You see Crumbs near the middle of the Plate and a smear of Sauce. Your roll behind the Char Siu pile, so the Human doesn't see you.

The Sink is to the west, and you see a Bowl to the east.

You can see a Char Siu, a Crumbs and a Sauce here.

>w
Sink (on the Sponge)
A basin filled halfway with soapy water. The water level is too deep for you to roll across, but will keep you hidden from the Human. A Sponge floats on top of the water right in front of you.

 The Kitchen Table Top is to the west, and the Plate is to the east.

>w
Kitchen Table Top (on the Sponge)
 The Human's Cutting Board and a Napkin Holder lie on the surface. After looking around, you see a Window, but it is elevated. You need to figure out a way to get out of the Window.

The Sink is to the east, and the Cabinet is to the West.

The Human is super hungry, and she waits for the steamed buns to finish cooking.

You can also see a Cutting Board (on which is a Green Onions) and a Napkin Holder here.

* * *

>test hga
(Testing.)

>[1] hide behind napkin holder
You roll behind the Napkin Holder. Now the Human can't see you.

>[2] eat green onions
You roll over the Cutting Board and eat a green onion, and then you feel a tingling in your body. Suddenly, you watch as two arms grow out of your body.

>[3] take chopsticks.
You take the Chopsticks with your newly grown arms.

Taken.

>w
Cabinet
The Cabinet is open. Boxes and jars of food fill the Cabinet. There is also a Utensil Crock filled with various tools.

The Kitchen Table Top is to the east.

>e
Kitchen Table Top
 The Human's Cutting Board and a Napkin Holder lie on the surface. After looking around, you see a Window, but it is elevated. You need to figure out a way to get out of the Window.

The Sink is to the east, and the Cabinet is to the West.

The Human is super hungry, and she waits for the steamed buns to finish cooking.

You can also see a Cutting Board (on which is a Green Onions) and a Napkin Holder here.

>e
Sink
A basin filled halfway with soapy water. The water level is too deep for you to roll across, but will keep you hidden from the Human. A Sponge floats on top of the water right in front of you.

 The Kitchen Table Top is to the west, and the Plate is to the east.

You can see a Sponge here.

* * *

>get on sponge
You roll onto the Sponge. It dips a little, but stays afloat and seem steady for your journey across the sink.

Sink (on the Sponge)
A basin filled halfway with soapy water. The water level is too deep for you to roll across, but will keep you hidden from the Human. A Sponge floats on top of the water right in front of you.

 The Kitchen Table Top is to the west, and the Plate is to the east.

>e
Plate (in the Sponge)
A Char Siu-filled plate. You see crumbs near the middle of the Plate and a smear of sauce. Your roll behind the Char Siu pile, so the Human doesn't see you.

The Sink is to the west, and you see a bowl to the east.

>get off sponge
But you aren't on the Sponge at the moment.

* * *

>w
Sink (in the Sponge)
A basin filled halfway with soapy water. The water level is too deep for you to roll across, but will keep you hidden from the Human. A Sponge floats on top of the water right in front of you.

 The Kitchen Table Top is to the west, and the Plate is to the east.

>get on sponge
But you're already in the Sponge.

>w
Kitchen Table Top (in the Sponge)
 The Human's Cutting Board and a Napkin Holder lie on the surface. After looking around, you see a Window, but it is elevated. You need to figure out a way to get out of the Window.

The Sink is to the east, and the Cabinet is to the West.

The Human is super hungry, and she waits for the steamed buns to finish cooking.

You can also see a Cutting Board (on which is a Green Onions) and a Napkin Holder here.

* * *

>w
Cabinet
The Cabinet is open. Boxes and jars of food fill the Cabinet. There is also a Utensil Crock filled with various tools.

The Kitchen Table Top is to the east.

>take spatula
You take the Spatula with your newly grown arms.

Taken.

>take spoon
You take the Wooden Spoon with your newly grown arms.

Taken.

>take toothpicks
You take the Toothpicks with your newly grown arms.

Taken.

>e
Kitchen Table Top
 The Human's Cutting Board and a Napkin Holder lie on the surface. After looking around, you see a Window, but it is elevated. You need to figure out a way to get out of the Window.

The Sink is to the east, and the Cabinet is to the West.

The Human is super hungry, and she waits for the steamed buns to finish cooking.

>e
Sink
A basin filled halfway with soapy water. The water level is too deep for you to roll across, but will keep you hidden from the Human.

 The Kitchen Table Top is to the west, and the Plate is to the east.

You can see a Sponge here.

>get on sponge
You roll onto the Sponge. It dips a little, but stays afloat and seem steady for your journey across the sink.

Sink (on the Sponge)
A basin filled halfway with soapy water. The water level is too deep for you to roll across, but will keep you hidden from the Human.

 The Kitchen Table Top is to the west, and the Plate is to the east.

>e
Plate (on the Sponge)
A Char Siu-filled plate. You see Crumbs near the middle of the Plate and a smear of Sauce. Your roll behind the Char Siu pile, so the Human doesn't see you.

The Sink is to the west, and you see a Bowl to the east.

>get off sponge
You dismount the Sponge.

Plate
A Char Siu-filled plate. You see Crumbs near the middle of the Plate and a smear of Sauce. Your roll behind the Char Siu pile, so the Human doesn't see you.

The Sink is to the west, and you see a Bowl to the east.

You can see a Sponge here.

>e
Bowl
You roll and plop yourself into a pool of Rice. You sink a little into the Rice to camouflage yourself from the Human.

The Plate is to the west. You see the Window above you, but you are too short to reach your freedom.

>take rice
You take some Rice. Maybe you can use it to  glue something and another thing together.

>u
Window
The Window is so high. It is open, letting the breeze from the outside flow through the kitchen. The beautiful blue sky and your freedom lie just on the other side.

The Bowl is below you.

You can see a Window Sill here.

>glue spatula and spoon
You can't use multiple objects with that verb.

>glue spatula to spoon
You glue together the Spatula and the Wooden Spoon, creating a sturdy structure.

You now have a a Spatula-Wooden Spoon Thing.

>glue spatula-wooden spoon thing to toothpicks
You glue together the Spatula-Wooden Spoon Thing and the Toothpicks, creating a sturdy structure.

You now have a a Ladder Thing.

You prop your makeshift ladder against the Window Sill and make your escape. You Win!

    *** The End ***

Would you like to RESTART, RESTORE a saved game, QUIT or UNDO the last command?

* * *

>w
Cabinet
The Cabinet is open. Boxes and jars of food fill the Cabinet.

The Kitchen Table Top is to the east.

You can see a Boxes, a jars and an Utensil Crock here.

>e
Kitchen Table Top
 The Human's Cutting Board and a Napkin Holder lie on the surface. After looking around, you see a Window, but it is elevated. You need to figure out a way to get out of the Window.

The Sink is to the east, and the Cabinet is to the West.

The Human is super hungry, and she waits for the steamed buns to finish cooking.

You can also see a Chopsticks, a Cutting Board (on which is a Green Onions) and a Napkin Holder here.

>get on sponge
You can't see any such thing.

* * *

>x buns
You see nothing special about the Steamed Buns.

>climb buns
You climb on top of the Steamed Bun next to you, but the cover is still closed, preventing you from escaping.

>put chopsticks in crack
You nudge the chopsticks into the crack until you know you have good leverage. Now all you have to do push the chopsticks to get the cover off.

>push chopsticks
You roll onto the end of the chopsticks, making the crack wider. After a couple more seconds, the cover is off, and it falls to the Kitchen Table Top. Now you can escape!

>climb bun
You climb out of the Steamer and fall on the Kitchen Table Top.

Kitchen Table Top
The Human is super hungry, and she waits for the steamed buns to finish cooking.

* * *

>x chopsticks
Two wooden sticks used as a utensil to eat or cook.

>pick up chopsticks
You try, but you don't have any hands yet. Try  pushing something.

>push chopsticks
You push the Chopsticks around and accidentally poke one of the other steamed buns!

>down
You try to roll out, but the Cover is still on.

>pushcover
That's not a verb I recognise.

>push cover
Nothing obvious happens.

>push steve
Steve might not like that.

>x crack
A small opening in the cover. You just need something to nudge the Crack open wider.

>push chopsticks
You push the Chopsticks around and accidentally poke one of the other steamed buns!

>push chopsticks the other way
You can't see any such thing.

>look
Steamer
A round, bamboo steamer resting on a pot of boiling water. The Human's chopsticks rest in the steamer, and five other steamed buns are huddled next to you. The cover is on the steamer, but you notice light coming through a crack in the top.

Steve is a fellow steamed bun huddled in the corner of the Steamer also trying not to be eaten.

You can also see a Chopsticks here.

>put chopsticks in crack
You nudge the chopsticks into the crack until you know you have good leverage. Now all you have to do push the chopsticks to get the cover off.

* * *

>push chopsticks
You roll onto the end of the chopsticks, making the crack wider. After a couple more seconds, the cover is off, and it falls to the Kitchen Table Top. Now you can go down and escape!

The Human turns to see what the noise was.

>down
Kitchen Table Top
 You land on the granite surface behind the Cover, so the Human can't see you.  The Human's Cutting Board and a Napkin Holder lie on the surface. After looking around, you see a Window, but it is elevated. You need to figure out a way to get out of the Window.

The Sink is to the east, and the Cabinet is to the West.

The Human is super hungry, and she waits for the steamed buns to finish cooking.

You can also see a Chopsticks, a Cutting Board (on which is a Green Onions) and a Napkin Holder here.

>e
Sink
A basin filled halfway with soapy water. The water level is too deep for you to roll across, but will keep you hidden from the Human. A Sponge floats on top of the water right in front of you.

 The Kitchen Table Top is to the west, and the Plate is to the east.

You can see a Sponge here.

>w
Kitchen Table Top
 The Human's Cutting Board and a Napkin Holder lie on the surface. After looking around, you see a Window, but it is elevated. You need to figure out a way to get out of the Window.

The Sink is to the east, and the Cabinet is to the West.

The Human is super hungry, and she waits for the steamed buns to finish cooking.

You can also see a Chopsticks, a Cutting Board (on which is a Green Onions) and a Napkin Holder here.

>e
Sink
A basin filled halfway with soapy water. The water level is too deep for you to roll across, but will keep you hidden from the Human. A Sponge floats on top of the water right in front of you.

 The Kitchen Table Top is to the west, and the Plate is to the east.

You can see a Sponge here.

>e
You plop into the water and slowly sink to the bottom.

    *** The End ***

Would you like to RESTART, RESTORE a saved game, QUIT or UNDO the last command?

>undo
Sink
[Previous turn undone.]

>w
Kitchen Table Top
 The Human's Cutting Board and a Napkin Holder lie on the surface. After looking around, you see a Window, but it is elevated. You need to figure out a way to get out of the Window.

The Sink is to the east, and the Cabinet is to the West.

The Human is super hungry, and she waits for the steamed buns to finish cooking.

You can also see a Chopsticks, a Cutting Board (on which is a Green Onions) and a Napkin Holder here.

>w
Cabinet
The Cabinet is open. Boxes and jars of food fill the Cabinet. There is also a Utensil Crock filled with various tools.

The Kitchen Table Top is to the east.

You can see a Boxes, a jars and an Utensil Crock here.

>e
Kitchen Table Top
 The Human's Cutting Board and a Napkin Holder lie on the surface. After looking around, you see a Window, but it is elevated. You need to figure out a way to get out of the Window.

The Sink is to the east, and the Cabinet is to the West.

The Human is super hungry, and she waits for the steamed buns to finish cooking.

You can also see a Chopsticks, a Cutting Board (on which is a Green Onions) and a Napkin Holder here.

>x cutting board
Freshly cut Green Onions lie on the Cutting Board.

On the Cutting Board is a Green Onions.

>x green onions
Circular, chopped green onions ready to be spread on a dish. They gleam like they hold special, secret powers.

>eat green onions
You roll over the Cutting Board and eat a green onion, and then you feel a tingling in your body. Suddenly, you watch as two arms grow out of your body.

>e
Sink
A basin filled halfway with soapy water. The water level is too deep for you to roll across, but will keep you hidden from the Human. A Sponge floats on top of the water right in front of you.

 The Kitchen Table Top is to the west, and the Plate is to the east.

You can see a Sponge here.

* * *

>get on sponge
You roll onto the Sponge. It dips a little, but stays afloat and seem steady for your journey across the sink.

Sink (on the Sponge)
A basin filled halfway with soapy water. The water level is too deep for you to roll across, but will keep you hidden from the Human. A Sponge floats on top of the water right in front of you.

 The Kitchen Table Top is to the west, and the Plate is to the east.

>w
Kitchen Table Top (on the Sponge)
 The Human's Cutting Board and a Napkin Holder lie on the surface. After looking around, you see a Window, but it is elevated. You need to figure out a way to get out of the Window.

The Sink is to the east, and the Cabinet is to the West.

The Human is super hungry, and she waits for the steamed buns to finish cooking.

You can also see a Chopsticks, a Cutting Board (on which is a Green Onions) and a Napkin Holder here.

>pick up chopsticks
You take the Chopsticks with your newly grown arms.

Taken.

>take napkin holder
You grab the Napkin Holder and pull, but it is too big and too heavy.

>put chopsticks in napkin holder
That can't contain things.

>w
Cabinet (on the Sponge)
The Cabinet is open. Boxes and jars of food fill the Cabinet. There is also a Utensil Crock filled with various tools.

The Kitchen Table Top is to the east.

You can see a Boxes, a jars and an Utensil Crock here.

>x crock
A tall, cylindrical tool holder that houses cooking utensils. The Spatula, Toothpicks, Tongs, Whisk, and Wooden Spoon are in the Holder.

>x tongs
Metal grabbers that are difficult for a small bun like you to open and close.

>x toothpicks
Little wooden sticks.

>x spatula
A sturdy, wooden spatula.

>x whisk
A mixer with many different slots between looped wires.

>x wooden spoon
A straight, wooden spoon.

>take spoon
You take the Wooden Spoon with your newly grown arms.

Taken.

>take whisk
You take the Whisk with your newly grown arms.

Taken.

>take toothpicks
You take the Toothpicks with your newly grown arms.

Taken.

>take tongs
You take the Tongs with your newly grown arms.

Taken.

>e
Kitchen Table Top (on the Sponge)
 The Human's Cutting Board and a Napkin Holder lie on the surface. After looking around, you see a Window, but it is elevated. You need to figure out a way to get out of the Window.

The Sink is to the east, and the Cabinet is to the West.

The Human is super hungry, and she waits for the steamed buns to finish cooking.

You can also see a Cutting Board (on which is a Green Onions) and a Napkin Holder here.

>up
Steamer (on the Sponge)
A round, bamboo steamer resting on a pot of boiling water. The Human's chopsticks rest in the steamer, and five other steamed buns are huddled next to you. The cover is on the steamer, but you notice light coming through a crack in the top.

Steve is a fellow steamed bun huddled in the corner of the Steamer also trying not to be eaten.

>take steve
You take Steve with your newly grown arms.

I don't suppose Steve would care for that.

>i
You are carrying:
  a Tongs
  a Toothpicks
  a Whisk
  a Wooden Spoon
  a Chopsticks

>talk to steve
"Hi, there," you say.

"Hi," he replies nervously.

"How long have you been in here," you ask.

"Long enough to know what's about to happen," Steve replies. 

"Do you know how to get out of here?" you ask.

Steve looks around nervously. "I heard the last successful steamed bun was able to escape after eating some green onion from the cutting board. But that was years ago, and you have to figure out how to get out of the steamer."

After hearing this, you decide against talking any further with Steve right now.

>down
Kitchen Table Top (on the Sponge)
 The Human's Cutting Board and a Napkin Holder lie on the surface. After looking around, you see a Window, but it is elevated. You need to figure out a way to get out of the Window.

The Sink is to the east, and the Cabinet is to the West.

The Human is super hungry, and she waits for the steamed buns to finish cooking.

You can also see a Cutting Board (on which is a Green Onions) and a Napkin Holder here.

>eat green onions
You roll over the Cutting Board and eat a green onion, and then you feel a tingling in your body. Suddenly, you watch as two arms grow out of your body.

>eat green onions
You roll over the Cutting Board and eat a green onion, and then you feel a tingling in your body. Suddenly, you watch as two arms grow out of your body.

>w
Cabinet (on the Sponge)
The Cabinet is open. Boxes and jars of food fill the Cabinet. There is also a Utensil Crock filled with various tools.

The Kitchen Table Top is to the east.

You can see a Boxes, a jars and an Utensil Crock here.

>e
Kitchen Table Top (on the Sponge)
 The Human's Cutting Board and a Napkin Holder lie on the surface. After looking around, you see a Window, but it is elevated. You need to figure out a way to get out of the Window.

The Sink is to the east, and the Cabinet is to the West.

The Human is super hungry, and she waits for the steamed buns to finish cooking.

You can also see a Cutting Board (on which is a Green Onions) and a Napkin Holder here.

>e
Sink (on the Sponge)
A basin filled halfway with soapy water. The water level is too deep for you to roll across, but will keep you hidden from the Human. A Sponge floats on top of the water right in front of you.

 The Kitchen Table Top is to the west, and the Plate is to the east.

>e
Plate (on the Sponge)
A Char Siu-filled plate. You see crumbs near the middle of the Plate and a smear of sauce. Your roll behind the Char Siu pile, so the Human doesn't see you.

The Sink is to the west, and you see a bowl to the east.

>e
Bowl (on the Sponge)
You roll and plop yourself into a pool of rice. You sink a little into the rice to camouflage yourself from the Human.

The Plate is to the west. You see the Window above you, but you are too short to reach your freedom.

An extremely sticky rice, almost as sticky as glue.

>i
You are carrying:
  a Tongs
  a Toothpicks
  a Whisk
  a Wooden Spoon
  a Chopsticks

>use tongs
That's not a verb I recognise.

>use spoon
That's not a verb I recognise.

>w
Plate (on the Sponge)
A Char Siu-filled plate. You see crumbs near the middle of the Plate and a smear of sauce. Your roll behind the Char Siu pile, so the Human doesn't see you.

The Sink is to the west, and you see a bowl to the east.

>x sauce
You can't see any such thing.

>x char siu
You can't see any such thing.

>x place
You can't see any such thing.

>x plate
You can't see any such thing.

>x crumbs
You can't see any such thing.

>get off sponge
You dismount the Sponge.

Plate
A Char Siu-filled plate. You see crumbs near the middle of the Plate and a smear of sauce. Your roll behind the Char Siu pile, so the Human doesn't see you.

The Sink is to the west, and you see a bowl to the east.

You can see a Sponge here.

>x crumbs
You can't see any such thing.

>e
Bowl
You roll and plop yourself into a pool of rice. You sink a little into the rice to camouflage yourself from the Human.

The Plate is to the west. You see the Window above you, but you are too short to reach your freedom.

An extremely sticky rice, almost as sticky as glue.

>take rice
You take the Rice with your newly grown arms.

Taken.

>up
Window
The Window is so high. It is open, letting the breeze from the outside flow through the kitchen. The beautiful blue sky and your freedom lie just on the other side.

The Bowl is below you.

You can see a Window Sill here.

>glue spoon to toothpicks
I didn't understand that sentence.

>glue spoon and toothpicks
You can't use multiple objects with that verb.

>glue spoon
What do you want to glue the Wooden Spoon and?

>glue spoon and toothpicks
You can't use multiple objects with that verb.

* * *

>x human
An old, Chinese woman.